NO textures/blue_stone.png
SO textures/color_stone.png
WE textures/grey_stone.png
EA textures/red_brick.png
H1 textures/hands_1.png
H2 textures/hands_2.png
H3 textures/hands_3.png
H4 textures/hands_4.png
H5 textures/hands_5.png
H6 textures/hands_6.png
H7 textures/hands_7.png
H8 textures/hands_8.png
H9 textures/hands_9.png
H10 textures/hands_10.png
H11 textures/hands_11.png
H12 textures/hands_12.png
H13 textures/hands_13.png
H14 textures/hands_14.png
H15 textures/hands_15.png
H16 textures/hands_16.png
DO textures/door.png
C 50,100,50
F 200,200,0

                 111111111111111111111111111111111111111111111111
                 1001000001                                     1
                 1001111101                                     1
                 1001000001                                     1
11111    11111   1001000001                                     1
10001    1000111110011111111111                                 1
10001    1000000000000000000011                                 1
10001    1000000000000000000011                                 1
10001    10001111011111111000011111111111111111111111111111111111
10001    10001  1010000001000110000000000000000000000000000000001
10001    10001  1011111111000010000010000000000000000000001000001
10001111110001  1000000000000010010010011111111111111111001001001
10000000000001  1111101111000010010000000000000000000000001001001
10000000000001      101111000010010011111111111111111111111001001
10000E00000001      100000000010010000000000000000000000000001001
10000000000001      100000000010011111111111111111111111111111001
11111111111111      111111000000000000000000000000000000000000001
100000001           10000000011111111111111111111111111111111101
111111001111111111111000000011                                101
100000001000100000000000000001                                101
100000000000000000000000000001                                101
1111111111000000000111111111111111111111111111111111111111111101111111
10000000010000000001000000000100000000000000001100000000000000000000001
10000000010000000001000000001100111111111111111100000000000000000000001
10000000010000000001000000001100000000000010000000000000000011110000001
1000000001000000000100000000010111111111111000000000000000001  10000001
1111111111000000000111111000010100000000000001100000000000001  10000001
1010000000011110000000001000010100000000000001100000111111111  10000001
10100000000111100000000010000101000000000000011111111          11111111
10100000000111100000000010000101001111111111111111111111111111111111111
10100000000111100000000011111101000000000000000000000000000000000000001
10111111111101100111100000000001010001000100010001000100010001000100101
10101111111111100111111100111111000100010001000100010001000100010001001
10101000000000000100000000000010010001000100010001000100010001000100011
10101111110111110101111100101111000100010001000100010001000100010001001
10101000000101000001000000000010010001000100010001000100010001000100011
10101011111101011101011100111111000100010001000100010001000100010001001
10101000000000010101000000000110010001000100010001000100010001000100011
10000011111111110101011100111111000100010001000100010001000100010001001
10101000001000010101000000000010010001000100010001000100010001000100011
10111111111111010101111111111111000100010001000100010001000100010001001
10000001000000000000000000000010010001000100010001000100010001000100011
11111111111111111111111111111111111111111111111111111111111111111111111