NO textures/path_to_the_north_texture
SO textures/path_to_the_south_texture
WE textures/path_to_the_west_texture
EA textures/path_to_the_east_texture

C 255,255,255
F 010,100,255


111111111
1000000001
1000000101
1000000001
1000000001
1000101W1
111111111