NO textures/blue_stone.png
SO textures/color_stone.png
WE textures/grey_stone.png
EA textures/red_brick.png

C 50,0,50
F 255,255,0

111111111
10000000W1
1000000001
1000000001
1000000001
1000001001
111111111