NO textures/blue_stone.png
SO textures/color_stone.png
WE textures/grey_stone.png
EA textures/red_brick.png
H1 textures/hands1.png
H2 textures/hands2.png
H3 textures/hands3.png
H4 textures/hands4.png
H5 textures/hands5.png
DO textures/door.png
C 50,0,50
F 255,255,0

        1111111111111111111111111
        1000000000010000000000001
        1010000000010000000000001
        1001000000010000000000001
11111111101000000001W0000000000D1
1000000000100000000D0011111111111
11110111111111000001000010001
11110111111111000001010010001
11000000100101000001000010001
10000000000000000001000010001
10000000000000000001000000001
11000001110101011111000000001
11110111 1110101   1000000001
11111111 1111111   1111111111