NO textures/blue_stone.png
SO textures/color_stone.png
WE textures/grey_stone.png
EA textures/red_brick.png
H1 textures/hands1.png
H2 textures/hands2.png
H3 textures/hands3.png
H4 textures/hands4.png
DO textures/door.png
C 50,0,50
F 255,255,0

        1111111111111111111111111
        1000000000110000000000001
        1011000001110000000000001
        10010000000DW0000000000001
111111111011000001110000000000001
100000000011000001110111111111111
11110111111111011100000010001
11110111111111011101010010001
11000000110101011100000010001
1000000000000000110000000001
10000000000000001101010000001
1100000111010101111101111000111
11110111 1110101 101111010001
11111111 1111111 111111111111
